Settings 10 12 40 hex
Win
Wilk 1 1 9
Wilk 1 0 9
Wilk 6 4 9
Wilk 3 0 9
Wilk 2 1 9
Wilk 3 2 9
Wilk 2 0 9
Wilk 2 4 9
Wilk 0 1 9
Wilk 2 2 9
Wilk 3 1 9
Wilk 0 0 9
Wilk 1 2 9
Wilk 4 3 9
Wilk 3 5 9
Wilk 3 4 9
Wilk 5 0 9
Wilk 4 1 9
Wilk 0 2 9
Wilk 4 2 9
Wilk 1 3 9
Wilk 6 1 9
Wilk 5 2 9
Wilk 0 3 9
Wilk 3 3 9
Wilk 2 3 9
Wilk 4 4 9
Wilk 4 0 9
Wilk 1 4 9
Wilk 5 1 9
Wilk 0 4 9
Wilk 2 5 9
Wilk 6 3 9
Wilk 2 6 9
Wilk 6 0 9
Wilk 7 2 9
Wilk 6 2 9
Wilk 4 5 9
Wilk 1 5 9
Wilk 0 5 9
Wilk 5 4 9
Wilk 7 1 9
Wilk 5 5 9
Wilk 1 6 9
Wilk 7 0 9
Wilk 9 0 9
Wilk 5 3 9
Wilk 6 7 9
Wilk 7 4 9
Wilk 3 6 9
Wilk 8 3 9
Wilk 2 7 9
Wilk 9 2 9
Wilk 4 6 9
Wilk 8 0 9
Wilk 6 6 9
Wilk 0 7 9
Mlecz 14 20 0
Mlecz 14 20 0
Mlecz 14 20 0
Mlecz 14 20 0
Mlecz 14 20 0
Mlecz 14 20 0
Mlecz 14 20 0
Mlecz 6 11 0
Mlecz 6 11 0
Mlecz 6 10 0
Mlecz 6 11 0
Mlecz 5 11 0
Mlecz 6 11 0
Mlecz 6 9 0
Mlecz 4 11 0
Mlecz 6 11 0
Mlecz 7 11 0
Mlecz 5 9 0
Mlecz 7 9 0
Mlecz 7 10 0
Mlecz 5 8 0
Mlecz 4 9 0
Wilk 7 5 9
Wilk 3 7 9
Wilk 8 1 9
Wilk 5 6 9
Wilk 8 4 9
Wilk 4 7 9
Wilk 9 1 9
Mlecz 6 8 0
Mlecz 4 10 0
Mlecz 8 11 0
Mlecz 4 8 0
LogWindow